*************************************************** *************************************************
*     *     *         *   *     *   *         *     *     *       *   *               *         *   *
*** * * * * *** ***** * *** *** * * * ******* * * *** * * * ***** * *** *** *********** ***** *** * *
*   * * * *   * *     * *   * *   *   *     * * * *   * *   *   * *   * *   *               *     * *
* *** *** *** * * ***** * *** ********* *** * * * * *** ******* * *** * * *** ******************* * *
*   * *   *   * * *     * *           *   * *   * * * *   *     *   *   *   * *                 * * *
*** * * *** *** * *** * * *** ***** ***** * ***** * * *** *** ***** * ***** * * *************** *** *
*   *   *       *     * *   * *   * *     *     *   *   *   *     * *     *   * *         *   *   * *
* ************************* *** * * * ********* * ***** *** * * *** ********* * ******* * * * *** * *
* *   *                   *     *   * * *       * *       * * * *           * *       * *   *   *   *
* * * * ***************** *** ******* * * ******* *** *** * * * * ********* *** ***** ******* ***** *
* * *       *     *     *     *   *   * *     * *   *   * * * * * *       *   * *     *   *   *   * *
* * ******* * *** * *** ******* * * *** ***** * *** *** * * *** * * ***** *** *** ***** * * *** * * *
*   *   * * *   * *   *   *     *   * *     * *     *   * *   *   *     *   *   *   *   * *     * * *
***** * * * * *** *** *** * ********* * *** * * ***** *** *** ***** ******* *** *** * *** * ***** * *
*     * *   * *     * * *   *   *   *   * *   * *     *     *       *     *   *     * * * * *     * *
* ***** * ***** ***** * ***** * * * * *** ***** * * ***************** *** * * ******* * * * * ***** *
* *   * *       *     *       * * *   *       * * *     *   *       * *   * * *       * * * * *     *
* * * * ******* * ***** ***** *** ******* *** * * ***** * * * ***** * *** *** * * ***** * * * * *****
* * *       *   * *         * *   *       *   * *     *   *   *     *   *     * *     *   * * * *   *
* ********* ***** ******* * *** ***** ***** *** ************* * ******* ******* ***** * ***** * * * *
*     *   *       *     * *     *     *       *   *         * * *       *     *     * * *     * * * *
* *** * * ******* * *** *** ***** *** *********** * ******* * * * ******* ******* *** * * * *** * * *
* * *   * *   * * *   *   *   *     * *         *   *     * * * *   *     *     * *   * * * *   * * *
* * ***** * * * * *** *** *** *** * *** ***** ********* * * * * *** *** * * *** * * *** * *** *** ***
*       * * * *   *     *   *   * *   *   * *           * * * *   *   * * * * *   * *     *   *     *
* ***** * * * ***** ******* *** * *** *** * *** ********* * ***** *** *** * * ***** ***** * *** *** *
* *   * *   *       *       *   *   * *   *   *       *   * *   *   * *   *       *   *   * *   *   *
*** * *************** ******* ******* * ***** ******* ***** * * * * * * ********* *** * *** * *** * *
*   *   *         *   *     * *     * *       *   *   *   * * *   * * *           *   * *   *   * * *
* ***** * ******* * *** ***** * *** * ******* * * * *** * * * ***** * ******* ***** *** * ******* ***
*     *   *     *   *   *     *   * *         * * *     *     *   * *   *   * *   * * * * *     *   *
* *** ***** *********** * ******* * *** ******* ******* ******* *** *** * * *** * * * * * *** * *** *
* *   *                 *         *   *     *   *     * *   *         *   *   * *   *   *   * *   * *
*** ***** ***** * ******************* ***** *** * *** *** * *************** * * ***** ***** * *** * *
*   *   * *   * * *     *     *     *   *       * *   *   *   *     *     * * *   * *   * *   * * * *
* *** * *** * *** * *** * * *** * * *** ***** *** * *** ***** * *** * *** *** *** * *** * ***** * * *
*     *     *   * * * * * *     * *   * *   * *   * *       * * * *   * *     *   *   *       *   * *
******* ******* * * * * * ******* *** * * * *** *** * ***** * * * ***** ******* *** *** ******* *** *
*     *     *   *     * * *     *   * *   *     *   *   *   * * * *   *       *   *     *       *   *
* *** ***** * ********* * * ******* * *********** ******* *** * * * * * *** * *** ******* ********* *
* * * *   * * *         * *   *     *   *       * *     * *     *   *     * *     *       *   *     *
* * * * * * * *** ***** * *** * ********* ***** * * *** * ******* ********* *** *** ******* *** * * *
* *     * * *   * * *   *   * *           *   * *   *   *     * * *     *   *   *   *           * * *
* ******* ***** * * * ***** * ************* * * ***** *** *** * * * *** * *** *** *************** * *
*       *   *   * * *     *         *   *   *   *   * * *   * *     *   * *   *   *             * * *
* ***** *** * *** * * ********* ***** * * *** *** * * * *** * *********** ***** *** *********** * ***
*     * * *   *   *   *   *     *   * *   *   *   * * *     *       *     *     *   *   *     * *   *
* ***** * ***** ***** * * * ***** * * ***** *** *** * * ***** ***** * ***** ***** ***** * *** * * * *
* *     * *         * * *       * *   *   *   * * *   * *   *     * *     * *     *     * * * * * * *
*** ***** * ******* * * ********* ***** ***** * * ***** * * ***** * ***** * *** *** * * * * * * *** *
* *   *   *     *   * * * *       *       *   * *       * *     * * *     * *   * * * * * * * * *   *
* * * * ***** *** *** * * * ************* * *** ******* * ***** *** * *** * * *** * * * * * * * * * *
* * * *       *   *   *   *       *     *     *       * * *     *   * *   * *   * * * * *   *   * * *
* *** * ***** * *** ***** ******* * *** ***** ******* * * ***** * *** * *** *** * * * ***** ***** * *
* *   * *   * * * *     * *   * *   * *   *       * * * *     * *   * * *   *   *   *     * *     * *
* * ***** * *** * ***** * * * * ***** *** ******* * * ******* * *** * *** *** ***** ***** * *** * * *
*   *     *     * *     *   *           *   *   *   *         *   * *     *   *   *     * *   * * * *
***** *********** * ******* *********** *** * * ***************** * * ******* * * ******* *** *** * *
*   *   *         *       * *     *       * * *           *     *   *   *   *   * *         *     * *
* * * * ******* * * ******* * *** ********* * *********** * *** ******* * * ***** * *************** *
* *   *       * *   *   *   *   *           *   *       *   * *       *   *       * *   *     *     *
* *********** * ***** * * ***** *********** *** ******* ***** ******* ************* * * * * *** *****
* *         * *     * * *   * * *     *     * *   *   *             *       * *     * *   *     *   *
* ***** *** * ******* * *** * * *** *** ***** *** * * ************* ***** * * * *** * ************* *
*   *   *   *   *     * *     *   *             *   *             *     * * * * * *   *             *
*** * *** ***** * ***** * ***** * *** *************************** * ***** * * * * ***** ********* ***
* *   *     *   *     *   *   * *   * *                     *   * *   *   *   *   *     *       *   *
* ***** ***** * ***** ***** * ***** *** *********** ******* * *** *** * ********* ***** *** ******* *
* *     * *   * * *   *   * *     * *   *   *       *     * *   *     *         *     *   * *       *
* * ***** * *** * * ***** * ***** * * ***** * ******* * *** *** ***** ********* ***** *** * * ***** *
*   *     * * * * *     * *   * *   *     * * *       *   *   *     * *   *   *     *   *   *     * *
* *** * *** * * * ***** * *** * *** ***** * * * ********* *** * *** * * *** * *** ***** ********* * *
* *   * *   * *   *     *   * *     *   * * * *     *   *   * * * * * *   * *   *     * *       * * *
* *** *** *** *** * ******* * * ***** * * * * ******* * *** * * * * * *** * * ******* * * ***** * * *
*   *   * *       * *       * *     * *   * *   *     *   *     *   *   * * * *   *   *   *   * * * *
*** *** * ***** *** * * * *** ******* ***** *** * ******* * *********** * * * * * * ******* * * * ***
* *     *     * *   * * * *   *     *     *   * *   * *   * *   *     * * * *   * *   *     *   *   *
* ***** ***** *** *** * *** *** *** ***** * *** *** * * ***** * * *** * * * ***** *** * *********** *
*     * *   *     * * *   *     * *     * * *   *   * *       *   *   * *   * *   *   *   *   *     *
* *** * *** ******* * *** ******* * *** * * * * * *** ************* *** * *** * * * * *** *** * * ***
* *   * *     *     * * *   *     *   * * * * * *     *   *       *     * *   * * * *   *   *   *   *
* * * * * *** * *** * * * *** *** *** *** * * ******* * * * ***** ******* *** * * * ******* * ***** *
* * * *   * * *   * * * * *   * *   * *     *       *   * *     *   *         * * *       * *   *   *
* * * ***** * *** * * * * * *** * * * * ********* * ***** ***** *** *********** * ******* * *** * * *
* * * * *   * *   * *   *   *   * * *   *       * *   *   *     * *         *   * *     *   *   * * *
*** * * * * * * *** *** ***** * * ******* ***** *** *** *** ***** ********* * *** *** * ********* ***
*   *   * *   *   * * *   *   * *       * *       *   * *   *       *     * *   *   * *         *   *
* ***** * ******* * * *** * *** ******* * ******* *** * * *** ***** * *** * *** *** ***** ***** * * *
* *   * * *       *   * * * * *     *   *       *   * * * * *     *   *   *   *   *       *   * * * *
* * * * * * * ******* * * * * *** *** * ***** * *** * * * * ***** ***** ***** * * ********* * * *** *
* * *   * * * *     * * *   *     *   * *   * * *     *   *       *   *       * * *   *     * * *   *
* ******* * * *** * * * ***** ***** *** * * *** *********** ******* * ********* * *** * * *** * * ***
*         * *   * *     *   *   *   * * * *     *   *     *     *   *       *   * *   * *   * * *   *
* ************* ********* * *** * *** * * ***** * * * * ******* ***** ***** ***** * * * *** *** * * *
* *           *   *       *     *   *   *   *   * * * *       *     * *     *   * * * *   *   * * * *
* *** ******* * * * *************** *** *** *** * * * ***** ******* * * ***** * * * * *** *** * * * *
* *   *   *   * *   *             *   * * *   * * * *   * *       *   * *     * * * *   * * *   * * *
* * *** * * ********* *********** *** * * *** *** * *** * *** ********* *** *** * * ***** * ******* *
*   *   *             *               *     *     *         *               *     *                 *
*************************************************** *************************************************

