***** ***
*       *
* * *** *
*       *
****** **