***** ***
*       *
* * **  *
*       *
****** **