************************* *************************
* * * * * * * * * * * * * * * * * * * * * * * * * *
*  *   *   *   *   *   *   *   *   *   *   *   *  *
* *  *   *   *   *   *   *   *   *   *   *   *  * *
*  *   *   *   *   *   *   *   *   *   *   *   *  *
* *  *   *   *   *   *   *   *   *   *   *   *  * *
*  *   *   *   *   *   *   *   *   *   *   *   *  *
* *  *   *   *   *   *   *   *   *   *   *   *  * *
*  *   *   *   *   *   *   *   *   *   *   *   *  *
* *  *   *   *   *   *   *   *   *   *   *   *  * *
*  *   *   *   *   *   *   *   *   *   *   *   *  *
* *  *   *   *   *   *   *   *   *   *   *   *  * *
*  *   *   *   *   *   *   *   *   *   *   *   *  *
* *  *   *   *   *   *   *   *   *   *   *   *  * *
*  *   *   *   *   *   *   *   *   *   *   *   *  *
* *  *   *   *   *   *   *   *   *   *   *   *  * *
*  *   *   *   *   *   *   *   *   *   *   *   *  *
* *  *   *   *   *   *   *   *   *   *   *   *  * *
*  *   *   *   *   *   *   *   *   *   *   *   *  *
* *  *   *   *   *   *   *   *   *   *   *   *  * *
*  *   *   *   *   *   *   *   *   *   *   *   *  *
* *  *   *   *   *   *   *   *   *   *   *   *  * *
*  *   *   *   *   *   *   *   *   *   *   *   *  *
* *  *   *   *   *   *   *   *   *   *   *   *  * *
*  *   *   *   *   *   *   *   *   *   *   *   *  *
* *  *   *   *   *   *   *   *   *   *   *   *  * *
*  *   *   *   *   *   *   *   *   *   *   *   *  *
* *  *   *   *   *   *   *   *   *   *   *   *  * *
*  *   *   *   *   *   *   *   *   *   *   *   *  *
* *  *   *   *   *   *   *   *   *   *   *   *  * *
*  *   *   *   *   *   *   *   *   *   *   *   *  *
* *  *   *   *   *   *   *   *   *   *   *   *  * *
*  *   *   *   *   *   *   *   *   *   *   *   *  *
* *  *   *   *   *   *   *   *   *   *   *   *  * *
*  *   *   *   *   *   *   *   *   *   *   *   *  *
* *  *   *   *   *   *   *   *   *   *   *   *  * *
*  *   *   *   *   *   *   *   *   *   *   *   *  *
* *  *   *   *   *   *   *   *   *   *   *   *  * *
*  *   *   *   *   *   *   *   *   *   *   *   *  *
* *  *   *   *   *   *   *   *   *   *   *   *  * *
*  *   *   *   *   *   *   *   *   *   *   *   *  *
* *  *   *   *   *   *   *   *   *   *   *   *  * *
*  *   *   *   *   *   *   *   *   *   *   *   *  *
* *  *   *   *   *   *   *   *   *   *   *   *  * *
*  *   *   *   *   *   *   *   *   *   *   *   *  *
* *  *   *   *   *   *   *   *   *   *   *   *  * *
*  *   *   *   *   *   *   *   *   *   *   *   *  *
* *  *   *   *   *   *   *   *   *   *   *   *  * *
*  *   *   *   *   *   *   *   *   *   *   *   *  *
* *  *   *   *   *   *       *   *   *   *   *  * *
************************* *************************
