************************* *************************
* * * * * * * * * * * * * * * * * * * * * * * * * *
*  *   *   *   *   *   *   *   *   *   *   *   *  *
* *  *   *   *   *   *   *   *   *   *   *   *  * *
*  *   *   *   *   *   *   *   *   *   *   *   *  *
* *  *   *   *   *   *   *   *   *   *   *   *  * *
*  *   *   *   *   *   *   *   *   *   *   *   *  *
* *  *   *   *   *   *   *   *   *   *   *   *  * *
*  *   *   *   *   *   *   *   *   *   *   *   *  *
* *  *   *   *   *   *   *   *   *   *   *   *  * *
*  *   *   *   *   *   *   *   *   *   *   *   *  *
* *  *   *   *   *   *   *   *   *   *   *   *  * *
*  *   *   *   *   *   *   *   *   *   *   *   *  *
* *  *   *   *   *   *   *   *   *   *   *   *  * *
*  *   *   *   *   *   *   *   *   *   *   *   *  *
* *  *   *   *   *   *   *   *   *   *   *   *  * *
*  *   *   *   *   *   *   *   *   *   *   *   *  *
* *  *   *   *   *   *   *   *   *   *   *   *  * *
*  *   *   *   *   *   *   *   *   *   *   *   *  *
* *  *   *   *   *   *   *   *   *   *   *   *  * *
*  *   *   *   *   *   *   *   *   *   *   *   *  *
* *  *   *   *   *   *   *   *   *   *   *   *  * *
*  *   *   *   *   *   *   *   *   *   *   *   *  *
* *  *   *   *   *   *   *   *   *   *   *   *  * *
*  *   *   *   *   *   *   *   *   *   *   *   *  *
* *  *   *   *   *   *   *   *   *   *   *   *  * *
*  *   *   *   *   *   *   *   *   *   *   *   *  *
* *  *   *   *   *   *   *   *   *   *   *   *  * *
*  *   *   *   *   *   *   *   *   *   *   *   *  *
* *  *   *   *   *   *   *   *   *   *   *   *  * *
*  *   *   *   *   *   *   *   *   *   *   *   *  *
* *  *   *   *   *   *   *   *   *   *   *   *  * *
*  *   *   *   *   *   *   *   *   *   *   *   *  *
* *  *   *   *   *   *   *   *   *   *   *   *  * *
*  *   *   *   *   *   *   *   *   *   *   *   *  *
* *  *   *   *   *   *   *   *   *   *   *   *  * *
*  *   *   *   *   *   *   *   *   *   *   *   *  *
* *  *   *   *   *   *   *   *   *   *   *   *  * *
*  *   *   *   *   *   *   *   *   *   *   *   *  *
* *  *   *   *   *   *   *   *   *   *   *   *  * *
*  *   *   *   *   *   *   *   *   *   *   *   *  *
* *  *   *   *   *   *   *   *   *   *   *   *  * *
*  *   *   *   *   *   *   *   *   *   *   *   *  *
* *  *   *   *   *   *   *   *   *   *   *   *  * *
*  *   *   *   *   *   *   *   *   *   *   *   *  *
* *  *   *   *   *   *   *   *   *   *   *   *  * *
*  *   *   *   *   *   *   *   *   *   *   *   *  *
* *  *   *   *   *   *   *   *   *   *   *   *  * *
*  *   *   *   *   *   *   *   *   *   *   *   *  *
* *  *   *   *   *   *   *   *   *   *   *   *  * *
************************* *************************
